Atlanta|Hawks|NBA
Boston|Celtics|NBA
Brooklyn|Nets|NBA
Charlotte|Bobcats|NBA
Chicago|Bulls|NBA
Cleveland|Cavaliers|NBA
Dallas|Mavericks|NBA
Denver|Nuggets|NBA
Detroit|Pistons|NBA
Golden State|Warriors|NBA
Houston|Rockets|NBA
Indiana|Pacers|NBA
LA|Clippers|NBA
LA|Lakers|NBA
Memphis|Grizzlies|NBA
Miami|Heat|NBA
Milwaukee|Bucks|NBA
Minnesota|Timberwolves|NBA
New Orleans|Hornets|NBA
New York|Knicks|NBA
Oklahoma City|Thunder|NBA
Orlando|Magic|NBA
Philadelphia|Sixers|NBA
Phoenix|Suns|NBA
Portland Trail|Blazers|NBA
Sacramento|Kings|NBA
San Antonio|Spurs|NBA
Toronto|Raptors|NBA
Utah|Jazz|NBA
Washington|Wizards|NBA