Arizona|Cardinals|NFL
Atlanta|Falcons|NFL
Baltimore|Ravens|NFL
Buffalo|Bills|NFL
Carolina|Panthers|NFL
Chicago|Bears|NFL
Cincinnati|Bengals|NFL
Cleveland|Browns|NFL
Dallas|Cowboys|NFL
Denver|Broncos|NFL
Detroit|Lions|NFL
Green Bay|Packers|NFL
Houston|Texans|NFL
Indianapolis|Colts|NFL
Jacksonville|Jaguars|NFL
Kansas City|Chiefs|NFL
LA|Rams|NFL
LA|Chargers|NFL
Miami|Dolphins|NFL
Minnesota|Vikings|NFL
New England|Patriots|NFL
New Orleans|Saints|NFL
NY|Giants|NFL
NY|Jets|NFL
Oakland|Raiders|NFL
Philadelphia|Eagles|NFL
Pittsburgh|Steelers|NFL
San Francisco|49ers|NFL
Seattle|Seahawks|NFL
Tampa Bay|Buccaneers|NFL
Tennessee|Titans|NFL
Washington|Redskins|NFL