Anaheim|Ducks|NHL
Arizona|Coyotes|NHL
Boston|Bruins|NHL
Buffalo|Sabres|NHL
Calgary|Flames|NHL
Carolina|Hurricanes|NHL
Chicago|Blackhawks|NHL
Colorado|Avalanche|NHL
Columbus|Blue Jackets|NHL
Dallas|Stars|NHL
Detroit|Red Wings|NHL
Edmonton|Oilers|NHL
Florida|Panthers|NHL
LA|Kings|NHL
Minnesota|Wild|NHL
Montreal|Canadiens|NHL
Nashville|Predators|NHL
New Jersey|Devils|NHL
New York|Islanders|NHL
New York|Rangers|NHL
Ottawa|Senators|NHL
Philadelphia|Flyers|NHL
Pittsburgh|Penguins|NHL
San Jose|Sharks|NHL
St. Louis|Blues|NHL
Tampa Bay|Lightning|NHL
Toronto|Maple Leafs|NHL
Vancouver|Canucks|NHL
Vegas|Golden Knights|NHL
Washington|Capitals|NHL
Winnipeg|Jets|NHL